9
+ + + + + + + + +
+       +       +
+       +       +
+     . Z .     +
+ + + . . . + + +
+     . @ .     +
+       +       +
+       +       +
+ + + + + + + + +
