10
          + +   + +
          +       +
. . . . . . . .   +
. . . I . @ . .   +
          +       +
          . .     +
          . .     +
          +       +
          +       +
          + +   + +
